ARI=Arizona Cardinals
ATL=Atlanta Falcons
BAL=Baltimore Ravens
BUF=Buffalo Bills
CAR=Carolina Panthers
CIN=Cincinnati Bengals
CHI=Chicago Bears
CLE=Cleveland Browns
DAL=Dallas Cowboys
DEN=Denver Broncos
DET=Detroit Lions
GNB=Green Bay Packers
HOU=Houston Texans
IND=Indianapolis Colts
JAX=Jacksonville Jaguars
KAN=Kansas City Chiefs
LAC=Los Angeles Chargers
LAR=Los Angeles Rams
LVR=Las Vegas Raiders
MIA=Miami Dolphins
MIN=Minnesota Vikings
NWE=New England Patriots
NOR=New Orleans Saints
NYG=New York Giants
NYJ=New York Jets
PHI=Philadelphia Eagles
PIT=Pittsburgh Steelers
SEA=Seattle Seahawks
SFO=San Francisco 49ers
TAM=Tampa Bay Buccaneers
TEN=Tennessee Titans
WAS=Washington Redskins